Lvl:1
x:50 y:30
nbDynObj:9
20000000000000000000000000000000000000000000022222
20000000000000000000000000000000000000000000022222
20000000000000000000000000000000000000000000022222
20000000000000000000000000000000000000000000022222
20000000000000000000000000000000000000000000002222
200000000000000000000000000000000000B0000000000222
20000000000000000000000000000000000000000000000222
20000000000000000000000000000000000011110000000222
20000000000000000000000000000000000002221000000222
20000000000000111100000000000000000000222100000022
20000000000001222200000000000000000000000000000002
20000000000012220000000000000000000000000000000002
20000000000000000000000000000000000000000000000002
200000000000000000000A0000000000000000050000000002
20000000000000000000000000000000000000000000000002
21111111111111111111111100000111000011111111111112
22222222222222222222222200000222000022220000002222
20000000222222200000022200000000000000000000000002
20000000222222000080002210000000000000000000000002
20000000022220000000002220000000000000000011000002
20000000022220000000000220000000000080000022008002
20000000022220000000000221000000000000000022000002
20000000002220000000000000000000000000000022000002
20000C0000090000000000000000000A000000000022000012
20000000000000011111111111100000000000000022000022
21111111111111122222222222211111111111111122111122
22222222222222222222222222222222222222222222222222
00000000000000000000000000000000000000000000000000
00000000000000000000000000000000000000000000000000
00000000000000000000000000000000000000000000000000

vl:2
x:50 y:30
nbDynObj:3
22000000000000000000000000000000000000000000000000
22000000000000000000000000000000000000000000000000
22000000000000000000000000000000000000000000000000
22000000000000000000000000000000000000000000000000
22000000000000000000000000000000000000000000000000
22000000000000000000000000000000000000000000000000
22000000000000000000000000000000000000000000000000
22000000000000000000000000000000000000000000000000
22000000000000000000000000000000000000000000000000
22000000000000000000000000000000000000000000000000
22000000000000000000000000000000000000000000000000
22000800900000000000000000000000000000000000000000
22000000000000000000000000000000000000000000000000
22000800000000000000000000000000000000000000000000
22000000000000000000000000000000000000000000000000
22000000000000000000000000000000000000000000000000
22000000000000000000000000000000000000000000000000
00000000000000000000000000000000000000000000000000
00000000000000000000000000000000000000000000000000
00000000000000000000000000000000000000000000000000
00000000000000000000000000000000000000000000000000
00000000000000000000000000000000000000000000000000
00000000000000000000000000000000000000000000000000
00000000000000000000000000000000000000000000000000
00000000000000000000000000000000000000000000000000
00000000000000000000000000000000000000000000000000
00000000000000000000000000000000000000000000000000
00000000000000000000000000000000000000000000000000
00000000000000000000000000000000000000000000000000
00000000000000000000000000000000000000000000000000
