Lvl:1
x:50 y:30
nbDynObj:11
00000000000000000022222000000000000000000000000000
00000000000000000022222000000000000000000000000000
00000000000000000022222000000000000000000000000000
00000000000000000022222000000000000000000000000000
00000000000000000022222000000000000000000000000000
00000000000000000022222000000000000000000000000000
00000000000000000022222000000000000000000000000000
00080000800008000022222000000000000000000000000000
00000000000000000022222000000000000000000000000000
00000000000000008022222000000000000000000000000000
00008000000000000002222000000000000000000000000000
00000000080000000000220000000000000000000000000000
000000000000000050009000C0000A00000000000000000000
0000000000B000000000000000000000000000000000000000
00000000000000011111111111111111111111110000000000
11111111111111122222222222222222222222220000000000
22222222222222222222222222222222222222220000000000
00000000000000000000000000000000000000000000000000
00000000000000000000000000000000000000000000000000
00000000000000000000000000000000000000000000000000
00000000000000000000000000000000000000000000000000
00000000000000000000000000000000000000000000000000
00000000000000000000000000000000000000000000000000
00000000000000000000000000000000000000000000000000
00000000000000000000000000000000000000000000000000
00000000000000000000000000000000000000000000000000
00000000000000000000000000000000000000000000000000
00000000000000000000000000000000000000000000000000
00000000000000000000000000000000000000000000000000
00000000000000000000000000000000000000000000000000
